#######.##
#.......####
#.........#
#........#
#.......#
#........#
#.........#
#......#..#
#.#......##
#.#@....##
##########